111111111111111
100000000000001
800000000000001
100000000000001
100000000000001
100000000000001
100000000000001
100000000000005
100000000000001
100000000000001
100000000000001
100000000000001
100000000000001
100000000000001
111111111111111